#########
#S     E#
# ### ###
#   #   #
### ### #
#       #
#########
